#######################################
# Syntax Coloring Map For HiBusServo
#######################################

#######################################
# Datatypes (KEYWORD1)
#######################################

HiBusServo  KEYWORD1

#######################################
# Methods and Functions (KEYWORD2)
#######################################

begin	KEYWORD2
moveTo	KEYWORD2
getPositionInDegrees	KEYWORD2
setAngleLimitsInDegrees	KEYWORD2
getAngleLimitsInDegrees	KEYWORD2
getMode	KEYWORD2
getAngleOffset	KEYWORD2
move	KEYWORD2
stop	KEYWORD2
setID	KEYWORD2
getID	KEYWORD2
setAngleOffset	KEYWORD2
saveAngleOffset	KEYWORD2
setAngleLimits	KEYWORD2
getAngleLimits	KEYWORD2
setVoltageLimits	KEYWORD2
getVoltageLimits	KEYWORD2
setMaxTemperatureLimit	KEYWORD2
getMaxTemperatureLimit	KEYWORD2
getTemperature	KEYWORD2
getVoltage	KEYWORD2
getPosition	KEYWORD2
setServoMode	KEYWORD2
setMotorMode	KEYWORD2
motorOn	KEYWORD2
motorOff	KEYWORD2
isMotorOn	KEYWORD2
ledOn	KEYWORD2
ledOff	KEYWORD2
setLedErrors	KEYWORD2
getLedErrors	KEYWORD2

#######################################
# Constants (LITERAL1)
#######################################

SERVO_MOVE_TIME_WRITE	LITERAL1
SERVO_MOVE_TIME_READ	LITERAL1
SERVO_MOVE_STOP	LITERAL1
SERVO_ID_WRITE	LITERAL1
SERVO_ID_READ	LITERAL1
SERVO_ANGLE_OFFSET_ADJUST	LITERAL1
SERVO_ANGLE_OFFSET_WRITE	LITERAL1
SERVO_ANGLE_OFFSET_READ	LITERAL1
SERVO_ANGLE_LIMIT_WRITE	LITERAL1
SERVO_ANGLE_LIMIT_READ	LITERAL1
SERVO_VIN_LIMIT_WRITE	LITERAL1
SERVO_VIN_LIMIT_READ	LITERAL1
SERVO_TEMP_MAX_LIMIT_WRITE	LITERAL1
SERVO_TEMP_MAX_LIMIT_READ	LITERAL1
SERVO_TEMP_READ	LITERAL1
SERVO_VIN_READ	LITERAL1
SERVO_POS_READ	LITERAL1
SERVO_OR_MOTOR_MODE_WRITE	LITERAL1
SERVO_OR_MOTOR_MODE_READ	LITERAL1
SERVO_LOAD_OR_UNLOAD_WRITE	LITERAL1
SERVO_LOAD_OR_UNLOAD_READ	LITERAL1
SERVO_LED_CTRL_WRITE	LITERAL1
SERVO_LED_CTRL_READ	LITERAL1
SERVO_LED_ERROR_WRITE	LITERAL1
SERVO_LED_ERROR_READ	LITERAL1
